F 139,69,19
SO ./imgs/murosur
NO ./imgs/muronorte
WE ./imgs/muroOeste
EA ./imgs/muroeste
C 135,206,235
        1111111111111111111111111
        1000000000110000000000001
        1011000001110000000000001
        1001000000000000000W00001
		1
111111111011000001110000000000001
100000000011000001 10111111111111
11110111111111011111000010001
11110111111111011101010010001
11000000110101011100000010001
10000000000000001100000000001
10000000000000000001010010001
1100000111010101111101111000111
11110111 1110101 101111010001
10000001 1111110 101111111111
11111111
