F 139,69,19
SO ./imgs/tech1
WE ./imgs/tech2
EA ./imgs/tech3
NO ./imgs/tech4
C 135,206,235
11111111111111
10000000000001
10000000000001
10000000W0000111111
11111110000000000001
      11111111111111